7 14
|------------|
|...|P.-....-|
|G.-|.H......|
|.G....-..-..|
|..........P-|
|...----....-|
|------------|